020202020202020202
020202282424242902
020202233233322202
020202231717172202
020202233217322202
020202272526253002
020202020214020202
020202020213150602
020202020202021402