282424242424291431
231717171717221401
231719171917221401
231717171717221401
231719171917221431
231717171717221401
272525262525301420
010101131515151010
010101310101030101