020202020202020202
010101010301010102
010328242424290102
010123211719220102
010123171717220102
020123171717220102
010127252625300102
151215150501310102
021602020202020202